...###
..##.#.####
.##..###..#
##........#
#...@..#..#
###..###..#